i-locals-pharmacy : Apotheke
i-fae-oven : Backofen
i-fae-badminton-racket : Badminton Schläger
i-locals-basketball-basket : Basketball Korb
i-fae-bed : Bett
i-locals-beer : Bierglas
i-locals-bread-croissant : Brot & Croissant
i-fae-iron : Bügeleisen
i-locals-cocktail : Cocktail
i-fae-couch : Couch
i-fae-shower : Dusche
i-fae-dvd : DVD
i-locals-groceries : Einkäufe
i-locals-shopping-bag : Einkfaustasche
i-fae-dinner-table : Esstisch
i-fae-bike : Fahrrad
i-fae-tv : Fernseher
i-fae-airport : Flughafen
i-locals-fruits : Früchte
i-fae-egg : Frühstücksei
i-fae-animal-footprints : Fußabdruck Tier
i-locals-soccer-field : Fußballfeld
i-fae-freezer : Gefrierschrank
i-fae-dishes : Geschirr
i-fae-barbecue : Grill
i-fae-floor-plan : Grundriss
i-fae-hand-mixer : Handmixer
i-locals-walk-dog : Hund Spaziergang
i-locals-ice-cream : Icecream
i-fae-coffee-machine : Kaffeemaschine
i-fae-pillows : Kissen
i-fae-air-conditioner : Klima Anlage
i-fae-kitchen-utensils : Küchen Utensilien
i-fae-fridge : Kühlschrank
i-locals-magazine : Magazin
i-locals-butcher-shop : Metzgerei
i-fae-microweave : Mikrowelle
i-fae-palm-tree : Palme
i-locals-petanque : Petanque
i-locals-pizza : Pizza
i-locals-postcard : Postkarte
i-locals-hair-cutter-comb : Schere & Kamm
i-fae-lounger : Sonnenliege
i-fae-cards : Spielkarten
i-fae-dish-machine : Spülmaschine
i-fae-beach : Strand
i-fae-swimming-pool : Swimming Pool
i-locals-tennis-racket : Tennis Schläger
i-fae-table-tennis-racket : Tischtennis Schläger
i-fae-toaster : Toaster
i-fae-toilet : Toilette
i-fae-cooler : Ventilator
i-locals-forest : Wald & Wege
i-fae-laundry-machine : Waschmaschine
i-fae-wifi : WiFi